000000000000000000000
011111111110111111110
010000000010000000010
010111110110111110110
010100010000100010010
010111011111101110110
010001000000001000011
011101111111111011110
000100010000000010000
011111110001111110110
010000010100000010010
010111110111111110110
010100000100000010010
010111111111111110110
010000000000000000010
011111111111111111110
000000000000000000000
