000011111111111111111
000000000001000000001
101100111101011111101
101000000001000000001
101011111111011111101
100010000000010000001
111011101111110111111
100000100000000100001
101100101111111101101
100000001000000001001
101111111011111111101
101000000000000000101
101011111111111111101
100000000000000000001
101111111011111111101
100000000000000000001
111111111111111111100