001111111111111111111
011111000000000000001
000011111111111111101
100000000000000000001
101111111011111111101
100000001000000000001
101111101011111111101
100000001000000000001
111111101111111101111
100000000000000000001
101111111111111111101
100000000000000000001
101111111011111111101
100000000000000000001
101111111111111111101
100000000000000000001
111111111001110111100
